###############
#     @       #
#             #
#             #
#   1         #
#      b      #
#             #
#   2         #
#             #
#             #
#   v         #
#             #
#             #
#             #
###############
